NO  img/ael-bekk.xpm
SO img/mel-hada.xpm
WE img/mabenchi.xpm
EA    img/zboudair.xpm

F 98,105,109
C 80,130,200

    111111111111  111111111111    
   100000000000011000000001001
  100000000100000100000000111
11000000001 100000000000001   
10000000000100000000000001     101
11000000000001000000000001      
  1100000000011100000000001
   10000000001010000000000011
  1000000000011100000000001
 100000000000N000000000001
1111111111111111111111111
