C 102,178,255
F 224,224,224

NO ./pics/bluestone.xpm
SO ./pics/greystone.xpm
WE ./pics/redbrick.xpm
EA ./pics/flag.xpm

    11111111111111  11111111111111   
   1000000000000001100000000001001
  1000000000010000010000000000111
1100000000001 10000000000000001   
1000000000000100000110000000001
110000000000000100000000000001      
  11000000000001110000000000001
   100000000000101000000W00000011
  10000000000001110000000000001
 10000000000000000000000000001
11111111111111111111111111111







